                                                                        |
                                                                        |
                                                                        |
                               t-----                                   |
                            ----    ----                                |
                           ----        ----                             |
                          ----         ----                             |
                          ----    s      ----                           |
                           ----         ----                            |
                            ----       ----                             |
                              ----   ----                               |
                                  -  --                                 |
                               ----    ----                             |
                                 ----     ----                          |
                                   ----      ----                       |
                                      ----     -----                    |
             -----                        ----    ----                  |
         ----    ----                    ----        ----               |
        ----        ----                ----         ----               |
       ----         ----                ----           ----             |
       ----           ----               ----         ----              |
        ----         ----                 ----       ----               |
         ----       ----                    ----   ----                 |
           ----   ----                            --                    |
                 ---                                                    |
                                                                        |
                                                                        |
                                                                        |
-------------------------------------------------------------------------