-------------------------------------------------------
|                                                     |
|                                                     |
|        ----------------------|                      |
|                            |                        |
|                            |                        |
|                            |                        |
|                            |                        |
|                            |                        |
|                            |                        |
|                    t       |                        |
|                            |                        |
|                            |                        |
|                            |                        |
|                            |                        |
|                            |                        |
|                            |                        |
|----------------------------|                        |
|                                                     |
|                                                     |
|                                                     |
|                                                     |
|                                                     |
|                                          s          |
|                                                     |
|                                                     |
|-----------------------------------------------------|
