-------------------------------------------------------
|                                                     |
|                                                     |
|        ----------------------|            -         |
|                            |                        |
|      -                     |                        |
|                        -   |                        |
|        -                   |                        |
|                            |                        |
|                            |         -              |
|                    s       |                        |
|                            |                        |
|                            |                        |
|    -      -                |-                       |
|                            | -                      |
|                        -   |  -                     |
|                            |  t-             -      |
|----------------------------|    -                   |
|                      -           -                  |
|                       -           -                 |
|                        -  ----------                |
|                         -           -               |
|                   -      -           -              |
|    --                     -           -  -          |
|                            -                        |
|                                                     |
|-----------------------------------------------------|
