-----------------------------------------------------------------   -
|s                                                                  |
------------------------------------------------------------------- |
|-----------------------------------------------------------------| |
------------------------------------------------------------------- |
|                                                                   |
-------------------  ------------------------------------------------
|-----------------|  |----------------------------------------------|
-------------------  ------------------------------------------------
| -----------              --------------------                     |
|             -----------                         ----------------- |
------------  |         | ----------- f --------------------------- |
|          |  ----------- |         |                               |
------------              -----------  ---------------------------- |
|             -----------             --                          | |
|    --- ------------------------- -------------------------------- |
|    |-|                           -----                            |
|    |-|  -----------------------                                   |
|    |-|  |---------------------|   ---------------------------------
|    |-|  -----------------------   |-------------------------------|
|    ---            |---|           ---------------------------------
|          ----     |---|     ----                    |-----|       |
|          |--|     |---|     |--|                    |-----|       |
|          |--|     |---|     |-----------------      |-----|    ----
|          |--|     |---|     |-----------------      |-----|    |--|
|          |--|     |---|     |--|                    |-----|    ----
|          |--|     -----     |--|            ----    -------       |
|          |--|               |--|            |--|                  |
---------------------------------------------------------------------
