      |                 |      
  s   |                 |      
      |                 |      
-------                 -------
                               
                               
                               
                               
                               
-------                 -------
      |                |       
      |                |   t   
      |                |       
      |                |       
