-----------------------------------------------------------------   -
|s                                                                  |
------------------------------------------------------------------- |
|-----------------------------------------------------------------| |
------------------------------------------------------------------- |
|                                                                   |
-------------------  -------------------------  ---------------------
|-----------------|  |-----------------------|  |-------------------|
-------------------  -------------------------  ---------------------
| -----------              --------------------                     |
|             -----------                         ----------------- |
------------  |         | -----------   --------------------------- |
|          |  ----------- |         |                               |
------------              -----------  ---------------------------- |
|             -----------             --                          | |
|    ---|---------------------------------------------------------- |
|    |-|                           -----                            |
|    |-|  -------- ----------------                                 |
|   -|-|  |------- -------------|   --------------------- -----------
|---t|-|  -------- -----------------|-------------------- ----------|
|    ---     |      |---|           --------------------- -----------
|          ----     |---|     ----                    |-- --|       |
|          |--|     |---|     |--|                    |-- --|       |
|          |--|     |---|     |-----------------      |-- --|    ----
|          |--|     |---|     |-----------------      |-- --|    |--|
|          |--|     |---|     |--|                    |--        ----
|          |--|     -----     |--|            ----    -------       |
|          |--|               |--|            |--|                  |
---------------------------------------------------------------------
