-------------------------------------------------------
|                                                     |
|                                                     |
|                            |                        |
|                            |                        |
|                            |                        |
|                            |                        |
|                            |                        |
|                            |                        |
|                            |                        |
|                    s       |                        |
|                            |                        |
|                            |                        |
|                            |                        |
|                            |                        |
|                            |                        |
|                            |                        |
|  --------------------------|                        |
|                                                     |
|                                                     |
|                                                     |
|                                                     |
|                                        f            |
|                                                     |
|                                                     |
|                                                     |
|-----------------------------------------------------|
