--------------------------------
|s                             |
|                              |
|                              |
|                              |
|                           f  |
|                              |
|                              |
|------------------------------|
