----------------------------
|s                         |
|||||||||||||||||||||||||| |
|||||||||||||||||||||||||| |
|||||||||||||||||||||||||| |
|||||||||||||||||||||||||| |
|||||||||||||||||||||||||| |
|||||||||||||||||||||||||| |
|                          |
|||||||||||||||||||||||||| |
|||||||||||||||||||||||||| |
|||||||||||||||||||||||||| |
|||||||||||||||||||||||||| |
                           |
|t                         |
---------------    ---------
