-----------------------------------------------------------------   -
|s                                                                  |
-                                                                   |
|-----------------------------------------------------------------| |
------------------------------------------------------------------- |
|                                                                   |
------------------| |------------------------|  ---------------------
|-----------------| |------------------------|  --------------------|
------------------| |------------------------|  ---------------------
| -----------              -------------------                      |
|             -----------                         ----------------- |
------------  |         | -----------   --------------------------- |
|          |  ----------- |         |                               |
------------              -----------  ---------------------------- |
|    t        -----------             --                          | |
|-------------------------------------------------------------------|
