-----------------------------------------------------------------   -
| s                                                                 |
-                                                                   |
-                                                                   |
-                                                                   |
-                                                                   |
|-----------------------------------------------------------------| |
------------------------------------------------------------------- |
|                                                                   |
-                                                                   |
-                                                                   |
------------------| |------------------------|  ---------------------
|-----------------| |------------------------|  --------------------|
------------------| |------------------------|  ---------------------
|t-----------              -------------------                      |
|             -----------                         ----------------- |
------------  |         | -----------   --------------------------- |
|          |  ----------- |         |                               |
------------              -----------  ---------------------------- |
|             -----------                                         | |
|-------------------------------------------------------------------|
