------------          ------
|s                         |
|||||||||||              |||
|||||||||||||||||||||||||| |
|||||||||||||||||||||||||| |
|||||||||||||||||||||||||| |
|||||||||||||||||||||||||| |
|||||||||||||||||||||||||| |
|                          |
|||||||||||||||||||||||||| |
|||||||||||||||||||||||||| |
|||||||||||||||||||||||||| |
|||||||||||||        ||||| |
||||                       |
|t                         |
------             ---------
