+-+-+-+-+-+-+-+-+-+-+-+-+-+-+-+
s       |             |       |
+ +-+-+ + +-+-+-+-+-+ + +-+ + +
|   |   |   |       |   |   | |
+-+ + +-+ + + +-+-+ +-+-+ +-+ +
|   |   | | |   |         |   |
+ +-+-+ + + +-+ +-+-+-+-+-+ +-+
|   |   | |   |     |       | |
+-+ + +-+-+-+ +-+-+ + +-+ +-+ +
|   |   |       |   |   |     |
+ +-+-+ + +-+-+-+ +-+-+ +-+-+ +
| |   |   |     |   | | |   | |
+ + + +-+-+ +-+ +-+ + + + + + +
| | | |       |       | | | | |
+ +-+ + +-+ +-+-+-+-+-+ + +-+ +
| |   |   | |   |   |   | |   |
+ + +-+-+ + + + + +-+ +-+ + +-+
|       | | | | |     | |   | |
+ +-+-+-+ + +-+ + +-+-+ +-+-+ +
| |       |     |   |   |     |
+ + +-+-+-+-+-+-+-+ + +-+ + + +
| | |     |         | |   | | |
+-+ + +-+ +-+-+-+-+-+ + +-+ + +
|   | |   |   |       | |   | |
+ +-+ + +-+ + + +-+-+ + + +-+ +
| |   |   | | |   |   | | |   |
+ + +-+-+ + + + + + +-+ + + +-+
|   |     | |   | |   | | | | |
+-+-+ + +-+ +-+-+ +-+ +-+ + + +
|     |     |       |     |   t
+-+-+-+-+-+-+-+-+-+-+-+-+-+-+-+